32 32
80 6
16 17 18 19 20 21 22 23 16 17 18 19 20 21 22 23 16 17 18 19 20 21 22 23 16 17 18 19 20 21 22 23 16 17 18 19 20 21 22 23 16 17 18 19 20 21 22 23 16 17 18 19 20 21 22 23 16 17 18 19 20 21 22 23 16 17 18 19 20 21 22 23 16 17 18 19 20 21 22 23 
32 33 34 35 36 37 38 39 32 33 34 35 36 37 38 39 32 33 34 35 36 37 38 39 32 33 34 35 36 37 38 39 32 33 34 35 36 37 38 39 32 33 34 35 36 37 38 39 32 33 34 35 36 37 38 39 32 33 34 35 36 37 38 39 32 33 34 35 36 37 38 39 32 33 34 35 36 37 38 39
16 17 18 19 20 21 22 23 16 17 18 19 20 21 22 23 16 17 18 19 20 21 22 23 16 17 18 19 20 21 22 23 16 17 18 19 20 21 22 23 16 17 18 19 20 21 22 23 16 17 18 19 20 21 22 23 16 17 18 19 20 21 22 23 16 17 18 19 20 21 22 23 16 17 18 19 20 21 22 23
32 33 34 35 36 37 38 39 32 33 34 35 36 37 38 39 32 33 34 35 36 37 38 39 32 33 34 35 36 37 38 39 32 33 34 35 36 37 38 39 32 33 34 35 36 37 38 39 32 33 34 35 36 37 38 39 32 33 34 35 36 37 38 39 32 33 34 35 36 37 38 39 32 33 34 35 36 37 38 39
16 17 18 19 20 21 22 23 16 17 18 19 20 21 22 23 16 17 18 19 20 21 22 23 16 17 18 19 20 21 22 23 16 17 18 19 20 21 22 23 16 17 18 19 20 21 22 23 16 17 18 19 20 21 22 23 16 17 18 19 20 21 22 23 16 17 18 19 20 21 22 23 16 17 18 19 20 21 22 23
32 33 34 35 36 37 38 39 32 33 34 35 36 37 38 39 32 33 34 35 36 37 38 39 32 33 34 35 36 37 38 39 32 33 34 35 36 37 38 39 32 33 34 35 36 37 38 39 32 33 34 35 36 37 38 39 32 33 34 35 36 37 38 39 32 33 34 35 36 37 38 39 32 33 34 35 36 37 38 39
